10
11
###########
.....###..#
####.###.##
####.###.##
##...###.##
##.#.###.##
##.#.....##
##.###.#...
##.....####
###########